0 0 0 0 0 0 0 0 0 0 0 0 0
0 0 0 0 0 0 0 0 0 0 0 0 0
0 4 3 4 0 4 2 4 5 6 0 0 0
9 9 9 4 1 0 4 2 1 1 0 1 0
1 2 3 4 5 6 0 0 2 2 0 0 0
9 9 9 9 9 9 9 0 9 9 9 9 0
1 2 1 1 1 1 2 1 0 3 0 0 0

