0 0 0 0 0 0 0 0 0 0 0 0 
0 9 9 9 9 9 9 9 9 9 9 0
0 9 2 2 2 2 2 2 2 2 9 0
0 9 3 3 3 3 3 3 3 3 9 0
0 9 0 5 5 5 5 5 0 5 9 0
0 9 0 6 6 6 6 6 0 6 9 0
0 0 9 9 9 9 9 9 9 9 0 0