9 0 9 0 9 0 8 0 9 0 9 0 9
9 0 9 0 9 0 8 0 9 0 9 0 9
9 4 9 5 9 6 8 6 9 5 9 4 9
9 0 0 0 0 0 0 0 0 0 0 0 9
9 6 9 6 9 6 9 6 9 6 9 6 9
9 7 9 7 9 7 9 7 9 7 9 7 9
9 9 9 9 9 9 9 9 9 9 9 9 9