0 0 0 0 0 0 0 0 0 0 0 0 0
0 0 0 0 1 1 1 1 1 0 0 0 0
0 2 2 2 2 2 2 2 2 2 2 2 0
0 0 0 0 0 9 0 9 0 0 0 0 0
0 3 3 3 9 0 0 0 9 3 3 3 0
0 4 4 4 7 0 0 0 7 4 4 4 0
0 9 9 9 9 0 0 0 9 9 9 9 0