0 0 0 0 0 0 0 0 0 0 0 0 0
0 0 0 0 0 0 0 0 0 0 0 0 0
9 1 4 9 5 9 9 9 5 9 4 1 9
0 2 0 3 0 4 0 4 0 3 0 2 0
2 0 3 0 4 0 5 0 4 0 3 0 2
0 3 0 4 0 5 0 5 0 4 0 3 0
2 0 3 0 4 0 4 0 4 0 3 0 2