0 0 0 0 0 0 0 0 0 0 0 0 0
0 0 0 0 0 0 0 0 0 0 0 0 0
0 0 0 0 0 0 0 0 0 0 0 0 0
0 0 2 3 4 4 4 4 4 4 3 2 1
0 2 3 4 5 5 5 5 5 5 4 3 2
2 3 4 5 6 6 6 6 6 6 5 6 6
9 9 9 9 9 9 9 9 9 9 9 9 0