0 0 0 0 0 0 0 0 0 0 0 0 0
0 0 0 0 1 1 1 1 1 1 1 1 1
0 0 0 4 4 4 4 4 4 4 3 2 1
0 0 1 1 5 5 5 5 5 1 2 1 2
0 1 1 1 6 6 6 6 6 1 1 1 1
1 9 9 1 9 9 1 9 9 9 0 0 0
0 0 0 0 0 0 0 0 0 0 0 0 0