0 0 0 0 0 0 0 0 0 0 0 0 0
0 0 0 0 0 0 0 0 0 0 0 0 0
0 0 0 0 0 0 0 0 0 0 0 0 0
0 0 2 3 4 4 4 4 4 4 3 2 1
0 2 3 4 5 5 5 5 5 1 2 1 2
2 3 4 5 6 6 6 6 6 1 1 1 1
9 9 9 9 9 9 9 9 9 9 0 0 0