0 0 0 0 0 0 0 0 0 0 0 0 0
0 0 0 0 0 0 0 0 0 0 0 0 0
0 0 0 0 0 0 0 0 0 0 0 0 0
2 3 4 5 9 9 0 9 9 5 4 3 2
2 3 4 5 9 9 0 9 9 5 4 3 2
2 3 4 5 8 8 0 8 8 5 4 3 2
2 3 4 5 7 7 0 7 7 5 4 3 2